Row : 20
Col : 15

300000000000003
300000000000003
300000000000003
300000000000003
300000000000003
300000000000003
300000000000003
300000000000003
300000000000003
300000000000003
300000000000003
300000000000003
300000000000003
300000000000003
300000000000003
300333333330003
333333003333333
303333333333333
333333333033333
333333333333333

